30 60
############################################################
#..........................................................#
#..........................................................#
#..........................................................#
#..........................................................#
#..........................................................#
#............##..............................##............#
#............##..............................##............#
#............##..............................##............#
#............##..............................##............#
#............##..............................##............#
#............##..............................##............#
#............##..............................##............#
#..........................................................#
#..........................................................#
#..........................................................#
#..........................................................#
#.............%................................@...........#
#..........................................................#
#..........................................................#
#..........................................................#
#..........................................................#
#.................#######################..................#
#.................#######################..................#
#..........................................................#
#..........................................................#
#..........................................................#
#..........................................................#
#..........................................................#
############################################################
