30 70
######################################################################
#....................................................................#
#....................................................................#
#...#................................................................#
#....................................................................#
#.....K..............................................................#
#....................................................................#
#....................................................................#
#....#...............................................................#
#....................................................................#
#....................................................................#
#....................................................................#
#....................................................................#
#........P.............................Z.............................#
#....................................................................#
#......................................Z.............................#
#............................................................%.......#
#......................................Z.............................#
#...........................@........................................#
#......................................Z.............................#
#......................................Z.............................#
#....................D......D.......D................................#
#....................................................................#
#.........................................................%..........#
#.............................%......................................#
#....................................................................#
#...@............................................................@...#
#....................................................................#
#....................................................................#
######################################################################
