30 70
######################################################################
#....................................................................#
#....................................................................#
#...............W....................................................#
#....................................................................#
#....................................................................#
#.......W...............W............................................#
#....................................................................#
#...............W....................................................#
#....................................................................#
#....................................................................#
#....................................................................#
#....................................................................#
#....................................................................#
#....................................................................#
#....................................................................#
#....................................................................#
#....................................................................#
#....................................................................#
#....................................................................#
#....................................................................#
#....................................................................#
#....................................................................#
#....................................................................#
#....................................................................#
#....................................................................#
#....................................................................#
#....................................................................#
#....................................................................#
######################################################################
