30 82
##################################################################################
##...............................................................................#
#................................................................................#
#............++++++++.+++++++.+.+++.++++++++++..++++++...........................#
#............+...................................................................#
#................................................................................#
#............+...................................................................#
#............+...................................................................#
#............+...................................................................#
#................................................................................#
#............+...................................................................#
#............+...................................................................#
#................................................................................#
#............+................W......................K...........................#
#............+...................................................................#
#............+...................................................................#
#............+...................................................................#
#................................................................................#
#............+...................................................................#
#............+...................................................................#
#............+...................................................................#
#............+...................................................................#
#................................................................................#
#............+...................................................................#
#............+...................................................................#
#................................................................................#
#................................................................................#
#................................................................................#
#................................................................................#
##################################################################################
