30 70
######################################################################
#....................................................................#
#....................................................................#
#..........P.........................................................#
#....................................................................#
#....................................................................#
#.......@............................................................#
#..............%.%..%%..%............................................#
#....................................................................#
#....................................................................#
#....................................................................#
#............Z.......................................................#
#..........................................@.........................#
#............Z.......................................................#
#............Z.............%.........................................#
#............Z.......................................................#
#............Z.......................................................#
#............Z.......................................................#
#............Z.......................................................#
#............Z.......................................................#
#....................................................................#
#....................................................................#
#....................................................................#
#....................................................................#
#....................................................................#
#....................................................................#
#....................................................................#
#....................................................................#
#....................................................................#
######################################################################
